04444444444444444444444444444444444444444444444444444444444411111111111111111111222222
04444444444444444444444444000000000000000000000000000000000000000000000000000000000000
04444444444444444444444444000000000000000000000000000000000000000000000000000000000000
04444444444444444444444444000000000000000000000000000000000000000000000000000000000000
00000000000000000000000000000000000000000000000000000000000000000000000000000000000000
00000000000000000000000000000000000000000000000000000000000000000000000000000000000000
00000000000000000000000000000000000000000000000000000000000000000000000000000000000000
00000000000000000000000000000000000000000000000000000000000000000000000000000000000000
00001222222222222222223000000000000000000000000000000000000000000000000000000000000000
00004444444444444444444000000000000000000000000000000000000000000000000000000000000000